G G G R G G G G W G G G G G G G G G G G
G G G R G G G G W G G G G G G G G G G G
G G G R G G G G W G . . G G G G G G G G
G G G R G G G G W G . . . . G G G G G G
G G G R G G G G G G . . . . G G G G G G
G G G R G G G G G G . . . . G G G G G G
G G G R G G G G G G . . 1 . G G G G G G
G G G R R R R R R R R R R G G G G G G G
G G G R G G G G G G G G G G G G G G G G
G G G R G G G G G G G G G G G G G G G G
G R R R G G G G G G G G G G G G G G G G
G R G G G G G G G G G G W W G G G G G G
G R G G G G G G G G W W W W W G G G G G
G R G G G G G G G G G G W W G G G G G G
G R G G G G G G G G G G G G G G G G G G
G R G G G G G G G G G G G G G G G G G G
G R G G G G G G G G G G G G G G G G G G
G R G G G G G G G G G G G G G G G G G G
G R G G G G G G G G G G G G G G G G G G
G R G G G G G G G G G G G G G G G G G G
G R G G G G G G G G G G G G G G G G G G
G R G G G G G G G G G G W G G G G G G G
G R G G G G G G G G G G G G G G G G G G
G R G G G G G G G G G G G G G G G G G G
G R G G G G G G G G G G W G G G G G G G
G R G G G G G G G G G G G G G G G G G G
G R G G G G . . . . . G G G G G G G G G
G R G G G G . . . . . G G G G G G G G G
G R G G G G . . . 2 . G W G G G G G G G
G R R G G G G G G R G G G G G G G G G G
G G R R R R R R R R R R R R R R R R R R
G G G G G G G G G G G G G G G G G G G G
G G G G G G G G G G G G G G G G G G G G
G G G G G G G G G G G G G G G G G G G G
