l l l l l l l l l l l l l l l l l l l l
l L L L L L L L L L L L L L L L L L L l
l L L L L L L L L L L L L L L L L L L l
l L L L L L L L L L L L L L L L L L L l
l L L L L L L L L L L L L L L L L L L l
l L L L L L L L L L L L L L L L L L L l
l L L L L L L L L L L L L L L L L L L l
l L L L L L L L L L L L L L L L L L L l
l L L L L L L L L L L L L L L L L L L l
l L L L L L L L L L L L L L L L L L L l
l L L L L L L L L L L L L L L L L L L l
l L L L L L L L L L L L L L L L L L L l
l L L L L L L L L L L L L L L L L L L l
l L L L L L L L L L L L L L L L L L L l
l l l l l l l l l X X l l l l l l l l l
